#List for games and corresponding name in qstat/quakestat
export a2s="Half-Life 2"
export ams="America's Army v2.x"
export bfs="BFRIS"
export cods="Call of Duty"
export crs="Command and Conquer: Renegade"
export d3g="Descent3 Gamespy Protocol"
export d3p="Descent3 PXO protocol"
export d3s="Descent3"
export dm3s="Doom 3"
export efm="Star Trek: Elite Force"
export efs="Star Trek: Elite Force"
export fcs="FarCry"
export grs="Ghost Recon"
export h2s="Hexen II"
export hl2s="Half-Life 2"
export hla2s="Half-Life"
export hlqs="Half-Life"
export hls="Half-Life"
export hrs="Heretic II"
export hws="HexenWorld"
export jk3s="Jedi Knight: Jedi Academy"
export kps="Kingpin"
export maqs="Medal of Honor: Allied Assault (Q)"
export mas="Medal of Honor: Allied Assault"
export mhs="Medal of Honor: Allied Assault"
export netp="NetPanzer"
export nexuizs="Nexuiz"
export preys="PREY"
export prs="Pariah"
export q2s="Quake II"
export q3s="Quake III: Arena"
export q4s="Quake 4"
export qs="Quake"
export qws="QuakeWorld"
export rss="Ravenshield"
export rws="Return to Castle Wolfenstein"
export sas="Savage"
export sfs="Soldier of Fortune"
export sgs="Shogo: Mobile Armor Division"
export sms="Serious Sam"
export sns="Sin"
export sof2s="Soldier of Fortune 2"
export t2s="Tribes 2"
export tbs="Tribes"
export tm="TrackMania"
export tremulous="Tremulous"
export ts2="Teamspeak 2"
export uns="Unreal"
export ut2004s="UT2004"
export ut2s="Unreal Tournament 2003"
export warsows="Warsow"
export woets="Enemy Territory"
